###E#
#...#
#.#.#
#...#
#.###
#S..#
#####
